حسني مبارك:ḥusnī mubārak
بسم:bism
و:wāw
ي:yā’
سوريا:Sūriyā
ع:ʿayn
ء:hamza
ا: alif
ب: bāʾ
ت: tāʾ
ث: thāʾ
ج: jīm
ح: ḥāʾ
خ: khāʾ
د: dāl
ذ: dhāl
ر: rāʾ
ز: zāy
س: sīn
ش: shīn
ص: ṣād
ض: ḍād
ط: ṭāʾ
ظ: ẓāʾ
غ: ghayn
ف: fāʾ
ق: qāf
ك: kāf
ل: lām
م: mīm
ن: nūn
ه: hāʾ
ة: tāʾ marbūṭa
قرآن:Qurʾan
شارع:shariʿa
علماء:ʿulamaʾ
كعبة:Kaʿba
اصول الفقه:uṣūl al-fiqh
عباية: abaya
عباسي: Abbasid
عبد العزيز: ʿAbd al-ʿAziz
عبد الحميد: ʿAbd al-Hamid
عائشة: ʿAʾisha
عكار: Akkar
الأندلس: al-Andalus
علوي: ʿAlawites
علي: ʿAli
عالم: ʿālim
علماء: ʿulamaʾ
الله: Allah
آل سعود: Al Saud
عاملي: ʿAmili
أمير: amir
عمان: Amman
عرق: arak
عاشوراء: ʿAshuraʾ
بعث: baʿth
بلاد المخزن: bilād al-makhzan
بلاد الشام: Bilad al-Sham
بلاد السيبة: bilād al-sība
بنت جبيل: Bint Jbeil
خلافة: caliphate
عهد عمر: Covenant of ʿUmar
دعوة: daʿwa
ذمي: dhimmī
أفندي: effendi
فقيه: faqīh
فتوى: fatwa
فلاح: fellah
فلاحين: fellahin
فيصل: Faisal
جلباب: galabiya
حديث: hadith
حج: hajj
حكيم: ḥakīm
حلال: halal
حمام: hammam
هاشمي: Hashimite
حجاب: hijab
الحجاز: Hijaz
هجرة: hijra
حزب الله: Hizbullah
الإمام الغائب: Hidden Imam
حور: houri
حسين بن علي: Husayn (ibn ʿAli)
اجتهاد: ijtihād
إخوان: ikhwān
الإخوان المسلمون: al-Ikhwan
إمام: imam
إسماعيلي: Ismaʿili
إسلامي: Islamicate
جهاد: jihad
جن: jinn
كعبة: Kaʿba
كافر: kafir
كوفية: kaffiyeh
مجلس: majlis
مجلس الشورى: majlis al-shūrā
مذهب: madhhab
مذاهب: madhāhib
مدرسة: madrasa
المغرب: Maghrib
مهدي: Mahdi
مسجد: masjid
محراب: mihrab
ملة: milla
منبر: minbar
مفتي: mufti
مجاهدين: mujahidin
مسلم: Muslim
معتزلة: Muʿtazila
قرآن: Qurʾan
صحوة: ṣaḥwa
صلاة: salat
سيد: sayyid
سادة: sāda
شريعة: shariʿa
شريف: sharīf
أشراف: ashrāf
شيخ: shaykh
شيخ الإسلام: shaykh al-Islam
شيعي: Shiʿi
شيعة: Shiʿa
تشيع: Shiʿism
سلطان: sultan
سنة: sunna
سني: Sunni
سوق: suq
سورة: sura
تنظيمات: tanzimat
أمة: umma
وقف: waqf
أوقاف: awqāf
وطن: waṭan
ولي: wali
أولياء: awliyāʾ
وهابي: Wahhabi
وهابية: Wahhabism
وزير: wazīr
زكاة: zakat
